{
    "name": "battlefield",
    "tileSize": 20,
    "width": 25,
    "height": 25,
    "data": [
      [7, 5, 5, 1, 1, 1, 1, 5, 5, 5, 5, 5, 7, 5, 1, 1, 1, 5, 5, 5, 5, 1, 5, 5, 7],
      [5, 1, 5, 5, 5, 5, 5, 5, 1, 1, 1, 5, 1, 5, 5, 5, 5, 5, 1, 1, 5, 1, 5, 1, 5],
      [5, 5, 5, 1, 1, 1, 1, 5, 5, 5, 1, 5, 1, 5, 1, 1, 1, 5, 5, 5, 5, 5, 5, 5, 5],
      [1, 5, 1, 5, 5, 5, 1, 1, 1, 5, 1, 5, 1, 5, 1, 3, 1, 5, 1, 5, 1, 1, 5, 1, 1],
      [1, 5, 1, 5, 1, 5, 5, 5, 5, 5, 1, 5, 1, 5, 1, 5, 1, 5, 1, 5, 5, 1, 5, 5, 5],
      [1, 5, 1, 5, 1, 5, 1, 1, 1, 5, 1, 5, 5, 5, 1, 5, 1, 5, 1, 1, 5, 5, 5, 1, 5],
      [1, 5, 1, 5, 1, 5, 5, 5, 1, 5, 1, 5, 1, 5, 1, 5, 5, 5, 1, 1, 1, 1, 5, 1, 5],
      [1, 5, 5, 5, 1, 2, 1, 5, 1, 5, 5, "p", 1, 5, 5, 5, 1, 5, 1, 5, 5, 5, 5, 5, 5],
      [1, 5, 1, 1, 1, 1, 1, 5, 1, 5, 1, 1, 1, 1, 1, 1, 1, 5, 1, 5, 1, 1, 1, 5, 1],
      [5, 5, 1, 5, 5, 5, 1, 5, 5, 5, 5, 5, 5, 5, 5, 5, 5, 5, 5, 5, 1, 5, 5, 5, 1],
      [5, 1, 1, 5, 1, 5, 1, 5, 1, 5, 1, 1, 5, 1, 1, 5, 1, 5, 1, 1, 1, 5, 1, 5, 1],
      [5, 5, 5, 5, 1, 5, 5, 5, 1, 5, 1, 5, 5, 5, 1, 5, 1, 5, 5, 5, 5, 5, 1, 5, 5],
      [7, 1, 1, 1, 1, 1, 5, 1, 1, 5, 5, 5, 1, 5, 5, 5, 1, 1, 5, 1, 1, 1, 1, 1, 7],
      [5, 5, 1, 5, 5, 5, 5, 5, 1, 5, 1, 5, 5, 5, 1, 5, 1, 5, 5, 5, 1, 5, 5, 5, 5],
      [1, 5, 1, 5, 1, 1, 1, 5, 1, 5, 1, 1, 5, 1, 1, 5, 1, 5, 1, 5, 1, 5, 1, 1, 5],
      [1, 5, 5, 5, 1, 5, 5, 5, 5, 5, 5, 5, 5, 5, 5, 5, 5, 5, 1, 5, 5, 5, 1, 5, 5],
      [1, 5, 1, 1, 1, 5, 1, 5, 1, 1, 1, 1, 1, 1, 1, 5, 1, 5, 1, 1, 1, 1, 1, 5, 1],
      [5, 5, 5, 5, 5, 5, 1, 5, 1, 5, 5, 5, 1, "g", 5, 5, 1, 5, 1, 2, 1, 5, 5, 5, 1],
      [5, 1, 5, 1, 1, 1, 1, 5, 5, 5, 1, 5, 1, 5, 1, 5, 1, 5, 5, 5, 1, 5, 1, 5, 1],
      [5, 1, 5, 5, 5, 1, 1, 5, 1, 5, 1, 5, 5, 5, 1, 5, 1, 1, 1, 5, 1, 5, 1, 5, 1],
      [5, 5, 5, 1, 5, 5, 1, 5, 1, 5, 1, 5, 1, 5, 1, 5, 5, 5, 5, 5, 1, 5, 1, 5, 1],
      [1, 1, 5, 1, 1, 5, 1, 5, 1, 3, 1, 5, 1, 5, 1, 5, 1, 1, 1, 5, 5, 5, 1, 5, 1],
      [5, 5, 5, 5, 5, 5, 5, 5, 1, 1, 1, 5, 1, 5, 1, 5, 5, 5, 1, 1, 1, 1, 5, 5, 5],
      [5, 1, 5, 1, 5, 1, 1, 5, 5, 5, 5, 5, 1, 5, 1, 1, 1, 5, 5, 5, 5, 5, 5, 1, 5],
      [7, 5, 5, 1, 5, 5, 5, 5, 1, 1, 1, 5, 7, 5, 5, 5, 5, 5, 1, 1, 1, 1, 5, 5, 7]
     ]
     
}