{
    "name": "Butterfly",
    "tileSize": 20,
    "width": 25,
    "height": 25,
    "data": [
      [1, 1, 1, 1, 1, 1, 1, 1, 1, 1, 1, 5, 3, 5, 1, 1, 1, 1, 1, 1, 1, 1, 1, 1, 1],
      [5, 7, 5, 5, 5, 5, 1, 7, 5, 5, 5, 5, 1, 5, 5, 5, 5, 7, 1, 5, 5, 5, 5, 7, 5],
      [5, 1, 1, 5, 1, 5, 1, 5, 1, 1, 1, 5, 1, 5, 1, 1, 1, 5, 1, 5, 1, 5, 1, 1, 5],
      [5, 1, 1, 5, 1, 5, 1, 5, 5, 5, 1, 5, 1, 5, 1, 5, 5, 5, 1, 5, 1, 5, 1, 1, 5],
      [5, 5, 1, 5, 1, 5, 5, 5, 1, 5, 1, 5, 1, 5, 1, 5, 1, 5, 5, 5, 1, 5, 1, 5, 5],
      [1, 5, 1, 5, 1, 1, 5, 1, 1, 5, 1, 5, 1, 5, 1, 5, 1, 1, 5, 1, 1, 5, 1, 5, 1],
      [1, 5, 1, "p", 5, 1, 5, 1, 5, 5, 5, 5, 1, 5, 5, 5, 5, 1, 5, 1, 5, "g", 1, 5, 1],
      [1, 5, 1, 1, 5, 1, 5, 1, 5, 1, 1, 1, 1, 1, 1, 1, 5, 1, 5, 1, 5, 1, 1, 5, 1],
      [1, 5, 1, 5, 5, 5, 5, 5, 5, 5, 1, 5, 7, 5, 1, 5, 5, 5, 5, 5, 5, 5, 1, 5, 1],
      [1, 5, 5, 5, 5, 1, 1, 1, 1, 5, 1, 5, 1, 5, 1, 5, 1, 1, 1, 1, 5, 5, 5, 5, 1],
      [1, 5, 1, 1, 5, 5, 5, 5, 5, 5, 1, 5, 1, 5, 1, 5, 5, 5, 5, 5, 5, 1, 1, 5, 1],
      [5, 5, 5, 1, 1, 5, 1, 1, 1, 5, 5, 5, 1, 5, 5, 5, 1, 1, 1, 5, 1, 1, 5, 5, 5],
      [5, 1, 5, 1, 1, 5, 5, 5, 1, 1, 1, 5, 1, 5, 1, 1, 1, 5, 5, 5, 1, 1, 5, 1, 5],
      [5, 1, 2, 1, 7, 5, 1, 5, 5, 5, 1, 5, 1, 5, 1, 5, 5, 5, 1, 5, 7, 1, 2, 1, 5],
      [5, 1, 5, 1, 5, 1, 1, 5, 1, 5, 1, 5, 5, 5, 1, 5, 1, 5, 1, 1, 5, 1, 5, 1, 5],
      [5, 5, 5, 1, 5, 5, 5, 5, 1, 5, 1, 1, 7, 1, 1, 5, 1, 5, 5, 5, 5, 1, 5, 5, 5],
      [1, 5, 1, 1, 1, 1, 5, 1, 1, 5, 5, 5, 5, 5, 5, 5, 1, 1, 5, 1, 1, 1, 1, 5, 1],
      [1, 5, 5, 5, 5, 5, 5, 5, 1, 5, 1, 1, 1, 1, 1, 5, 1, 5, 5, 5, 5, 5, 5, 5, 1],
      [1, 1, 5, 1, 1, 1, 1, 5, 1, 5, 5, 5, 5, 5, 5, 5, 1, 5, 1, 1, 1, 1, 5, 1, 1],
      [1, 5, 5, 5, 5, 5, 5, 5, 5, 5, 1, 1, 1, 1, 1, 5, 5, 5, 5, 5, 5, 5, 5, 5, 1],
      [1, 5, 1, 1, 1, 5, 1, 5, 1, 5, 1, 5, 7, 5, 1, 5, 1, 5, 1, 5, 1, 1, 1, 5, 1],
      [1, 5, 1, 5, 5, 5, 1, 5, 1, 5, 5, 5, 1, 5, 5, 5, 1, 5, 1, 5, 5, 5, 1, 5, 1],
      [1, 5, 1, 5, 1, 1, 1, 5, 1, 1, 1, 5, 1, 5, 1, 1, 1, 5, 1, 1, 1, 5, 1, 5, 1],
      [1, 7, 5, 5, 5, 5, 5, 5, 5, 5, 5, 5, 1, 5, 5, 5, 5, 5, 5, 5, 5, 5, 5, 7, 1],
      [1, 1, 1, 1, 1, 1, 1, 1, 1, 1, 1, 5, 3, 5, 1, 1, 1, 1, 1, 1, 1, 1, 1, 1, 1]
    ]
}